XXXXXXXXXXXXXXXXXXXXXXXXXXXXXXXXXXXXXXXXXXXXXXXXXXXXX
XXX.XXXXX                XXXXX            XXXXXXXXXXX
XXX XXXXXXXXXXXXXXXXXXXXXXXXXX XXXXXXXXXX XXXXXXXXXXX
XXX XX                XXXXXXXX XXX   XXXX XXXXX  XXXX
XXX XX XXXXXXXXXXXXXX XXXXXXXX XXX   XXXX XXXXX  XXXX
XXX XX XXXXXXXXXXXXXX XX X XXX XXX   XXXX XXXXX  XXXX
XXX XX XXX     XXXXXX XX X XXX XXX   XXXX XXXXX  XXXX
XXX XX XXX XXX XXXXXX XX X XXX XXX   XXXX XXXXX  XXXX
XXX XX XXX XXX XXXXXX XX X XXX XXXXXXXXXX XXXXX  XXXX
XXX XX     XXX XXXXXX XX X XXX      XXXXX XXXXX  XXXX
XXX XXXXXXXXXX XXXXXX XX X XXXXXXXX XXXXX XXXXX  XXXX
XXX XXX        XXXXXX XXXXXXXX  XXX XXXXX XXXXX  XXXX
XXX XXX XXXXXXXXXXXXX      XXX  XXX XXXXX XXXXX  XXXX
XXX XXX XX         XXXXXXX XXX  XXX XXXXX XXXXXXXXXXX
XXX     XXX            XXX XXXXXXXX XXXXX            .
XXXXXXXXXXX            XXX          XXXXXXXXXXXXXXXXX
XXXXXXXXXXXXXXXXXXXXXXXXXXXXXXXXXXXXXXXXXXXXXXXXXXXXX
